30 30
m00010000000000000000000000100
110101011111111111101111110100
000010100000010000000000100000
011101011110111111111110101100
010000100000010000000000101010
011111101110111111111110101010
000000000100010000000000001010
111110111110101111111011101010
000010100000010000100000001010
111011110111111101111111101010
000000000100000001000000001010
000101011110111111100010001110
011111111011111011111110101010
010000000101000000001000001010
011111101110111111110101110100
000000000000000000000000000010
011111111011111111110101111010
000000000100000000001000001010
111111110111111111101110111010
000000000000100000000000000010
111110111111101111111011110010
000010100000100000001000000010
111110111110111111011111111010
000000101000000000000000010010
111111101011111111111111111110
010000000000000000000000001000
011111110111111101111111101000
000000000000000000000000000000
111001100111011111011011110000
00010101111010110110001000111e