30 30
010000100000000000010000010000
011110101111101111110111011110
010010001000101000000100000100
010111101110101011111111110101
000000100000101000010000010100
111101101111100011011101110110
001001001000111110010001000010
101011011010100011110111011000
001001001011101010000001001110
011101101010001000111101111000
000001000010111110100100101011
010111011110100010101110000000
110100010000101010100000101110
000101110110101010111111100100
011100010100101010101000001101
000001110110101000100010111000
011111000101111111101110101110
010000011100000010001000001010
010111110111101000101011101000
110101010000001101111000111011
0100010101111010m1010010001110
011111010100101011000110100010
010000010110101010011100111010
011111010100101111110001101110
010001010101101000111111101010
011101010000100010001010100010
000101011110111111100e10001110
010101000000001000111110100000
010101011111101110100011111011
010000010000000000001000000000